O,O,D,#,B,/
O,#,#,/,#,/
/,#,S,/,#,/
/,#,/,S,#,/
/,#,/,#,#,X
/,B,#,D,X,X
